244444444444444447000000000000
000000000000000007000000000000
000000755555000007000000000000
000000700006000007000000000000
000000700006555555000000000000
000000700000000000000000000000
000000700000000000000000000000
000000700000000000000000000000
000000444444444444444447000000
000000000000000000000007000000
000000000000000000000755000000
000000000000000000755500000000
000000000000000000700000000000
000000000000000000444700000000
000000000000000000000444470000
000000000000000000000000070000
007555555555555555555555550000
007000000000000000000000000000
004444444444444444470000000000
000000000000000000030000000000